Ein	ART.Nom.Sg.Masc	ein
König	NN.Nom.Sg.Masc	König
hatte	VAFIN.3.Sg.Past.Ind	haben
eine	ART.Acc.Sg.Fem	ein
Tochter	NN.Acc.Sg.Fem	Tochter
,	$,	,
die	PRELS.Nom.Sg.Fem	der
war	VAFIN.3.Sg.Past.Ind	sein
überaus	ADV	überaus
schön	ADJD.Pos	schön
und	KON	und
klar	ADJD.Pos	klar
und	KON	und
hatte	VAFIN.3.Sg.Past.Ind	haben
eine	ART.Acc.Sg.Fem	ein
gar	ADV	gar
feine	ADJA.Pos.Acc.Sg.Fem	fein
und	KON	und
zarte	ADJA.Pos.Acc.Sg.Fem	zart
Haut	NN.Acc.Sg.Fem	Haut
;	$.	;
wenn	KOUS	wenn
sie	PPER.3.Nom.Sg.Fem	sie
rothen	ADJA.Pos.Acc.Sg.Masc	roth
Wein	NN.Acc.Sg.Masc	Wein
trank	VVFIN.3.Sg.Past.Ind	trinken
,	$,	,
konnte	VMFIN.3.Sg.Past.Ind	können
man	PIS.Nom.Sg.*	man
sehen	VVINF.Inf	sehen
,	$,	,
wie	PWAV	wie
er	PPER.3.Nom.Sg.Masc	er
ihr	PPER.3.Dat.Sg.Fem	ihr
durch	APPR	durch
den	ART.Acc.Sg.Masc	der
Hals	NN.Acc.Sg.Masc	Hals
herunter	ADV	herunter
lief	VVFIN.3.Sg.Past.Ind	laufen
.	$.	.

