Ein	ART.Nom.Sg.Masc	ein
König	NN.Nom.Sg.Masc	König
hatte	VAFIN.3.Sg.Past.Ind	haben
eine	ART.Acc.Sg.Fem	ein
Frau	NN.Acc.Sg.Fem	Frau
genommen	VVPP.Psp	nehmen
,	$,	,
die	PRELS.Nom.Sg.Fem	der
war	VAFIN.3.Sg.Past.Ind	sein
zwar	ADV	zwar
von	APPR	von
hoher	ADJA.Pos.Dat.Sg.Fem	hoher
Geburt	NN.Dat.Sg.Fem	Geburt
,	$,	,
aber	KON	aber
nicht	PTKNEG	nicht
von	APPR	von
hohem	ADJA.Pos.Dat.Sg.Masc	hohem
Sinn	NN.Dat.Sg.Masc	Sinn
und	KON	und
brach	VVFIN.3.Sg.Past.Ind	brechen
ihm	PPER.3.Dat.Sg.Masc	ihm
ihre	PPOSAT.Acc.Sg.Fem	ihr
Treue	NN.Acc.Sg.Fem	Treue
jeden	PIAT.Acc.Sg.Masc	jeder
Tag	NN.Acc.Sg.Masc	Tag
.	$.	.

