Ein	ART.Nom.Sg.Masc	ein
fremder	ADJA.Pos.Nom.Sg.Masc	fremder
Wandergast	NN.Nom.Sg.Masc	Wandergast
trat	VVFIN.3.Sg.Past.Ind	treten
in	APPR	in
ein	ART.Acc.Sg.Neut	ein
Bauernhaus	NN.Acc.Sg.Neut	Bauernhaus
,	$,	,
und	KON	und
fand	VVFIN.3.Sg.Past.Ind	finden
allda	ADV	allda
die	ART.Acc.Sg.Fem	der
Familie	NN.Acc.Sg.Fem	Familie
,	$,	,
den	ART.Acc.Sg.Masc	der
Vater	NN.Acc.Sg.Masc	Vater
mit	APPR	mit
Frau	NN.Dat.Sg.Fem	Frau
und	KON	und
Kindern	NN.Dat.Pl.Neut	Kind
in	APPR	in
trüber	ADJA.Pos.Dat.Sg.Fem	trüber
Stimmung	NN.Dat.Sg.Fem	Stimmung
und	KON	und
in	APPR	in
Trauerkleidern	NN.Dat.Pl.Neut	Trauerkleid
,	$,	,
denn	KON	denn
ihnen	PPER.3.Dat.Pl.Masc	ihnen
war	VAFIN.3.Sg.Past.Ind	sein
vor	APPR	vor
wenigen	PIAT.Dat.Pl.Fem	weniger
Wochen	NN.Dat.Pl.Fem	Woche
ein	ART.Nom.Sg.Neut	ein
liebes	ADJA.Pos.Nom.Sg.Neut	liebes
und	KON	und
schönes	ADJA.Pos.Nom.Sg.Neut	schönes
Kind	NN.Nom.Sg.Neut	Kind
,	$,	,
ein	ART.Nom.Sg.Neut	ein
Mädchen	NN.Nom.Sg.Neut	Mädchen
gestorben	VVPP.Psp	sterben
.	$.	.

