»	XY	»
Es	PPER.3.Nom.Sg.Neut	es
war	VAFIN.3.Sg.Past.Ind	sein
einmal	ADV	einmal
eine	ART.Nom.Sg.Fem	ein
arme	ADJA.Pos.Nom.Sg.Fem	arm
Frau	NN.Nom.Sg.Fem	Frau
«	NE.Nom.Sg.Fem	«
,	$,	,
erzählte	VVFIN.3.Sg.Past.Ind	erzählen
die	ART.Nom.Sg.Fem	der
Schlange	NN.Nom.Sg.Fem	Schlange
:	$.	:
»	$(	»
die	PDS.Nom.Sg.Fem	der
ging	VVFIN.3.Sg.Past.Ind	gehen
eines	ART.Gen.Sg.Masc	ein
Morgens	NN.Gen.Sg.Masc	Morgen
auf	APPR	auf
die	ART.Acc.Sg.Fem	der
Wiese	NN.Acc.Sg.Fem	Wiese
,	$,	,
Gras	NN.Acc.Sg.Neut	Gras
zu	PTKZU	zu
mähen	VVINF.Inf	mähen
,	$,	,
und	KON	und
trug	VVFIN.3.Sg.Past.Ind	tragen
mit	APPR	mit
sich	PRF.3.Dat.Sg	sich
ihr	PPOSAT.Acc.Sg.Neut	ihr
kleines	ADJA.Pos.Acc.Sg.Neut	klein
Kind	NN.Acc.Sg.Neut	Kind
,	$,	,
das	PRELS.Nom.Sg.Neut	der
noch	ADV	noch
an	APPR	an
ihrer	PPOSAT.Dat.Sg.Fem	ihr
Brust	NN.Dat.Sg.Fem	Brust
trank	VVFIN.3.Sg.Past.Ind	trinken
.	$.	.

[	XY	[
…	XY	…
]	XY	]
«	XY	«

