Vor	APPR	vor
ganz	ADV	ganz
undenklich	ADJD.Pos	undenklich
langer	ADJA.Pos.Dat.Sg.Fem	langer
Zeit	NN.Dat.Sg.Fem	Zeit
,	$,	,
da	ADV	da
gab	VVFIN.3.Sg.Past.Ind	geben
es	PPER.3.Nom.Sg.Neut	es
noch	ADV	noch
gar	ADV	gar
kein	PIAT.Acc.Sg.Neut	kein
Christkindchen	NN.Acc.Sg.Neut	Christkindchen
,	$,	,
sondern	KON	sondern
nur	ADV	nur
eine	ART.Acc.Sg.Fem	ein
Frau	NN.Acc.Sg.Fem	Frau
Holle	NE.Nom.Sg.Fem	Holle
,	$,	,
die	PRELS.Nom.Sg.Fem	der
wohnte	VVFIN.3.Sg.Past.Ind	wohnen
nicht	PTKNEG	nicht
weit	ADJD.Pos	weit
von	APPR	von
uns	PPER.1.Dat.Pl.*	uns
auf	APPR	auf
der	ART.Dat.Sg.Fem	der
höchsten	ADJA.Sup.Dat.Sg.Fem	hoch
Spitze	NN.Dat.Sg.Fem	Spitze
der	ART.Gen.Pl.Masc	der
Odenwaldberge	NN.Gen.Pl.Masc	Odenwaldberg
,	$,	,
auf	APPR	auf
der	ART.Dat.Sg.Fem	der
kalten	ADJA.Pos.Dat.Sg.Fem	kalt
,	$,	,
windigen	ADJA.Pos.Dat.Sg.Fem	windig
Böllsteiner	ADJA.Pos.*.*.*	Böllsteiner
Höhe	NN.Dat.Sg.Fem	Höhe
.	$.	.

