Es	PPER.3.Nom.Sg.Neut	es
war	VAFIN.3.Sg.Past.Ind	sein
einmal	ADV	einmal
ein	ART.Nom.Sg.Masc	ein
kleiner	ADJA.Pos.Nom.Sg.Masc	kleiner
Knabe	NN.Nom.Sg.Masc	Knabe
,	$,	,
der	PDS.Nom.Sg.Masc	der
hatte	VAFIN.3.Sg.Past.Ind	haben
sich	PRF.3.Acc.Sg	sich
erkältet	VVPP.Psp	erkälten
;	$.	;
er	PPER.3.Nom.Sg.Masc	er
war	VAFIN.3.Sg.Past.Ind	sein
ausgegangen	VVPP.Psp	ausgehen
und	KON	und
hatte	VAFIN.3.Sg.Past.Ind	haben
nasse	ADJA.Pos.Acc.Pl.Masc	naß
Füße	NN.Acc.Pl.Masc	Fuß
erhalten	VVPP.Psp	erhalten
,	$,	,
niemand	PIS.Nom.Sg.Masc	niemand
konnte	VMFIN.3.Sg.Past.Ind	können
begreifen	VVINF.Inf	begreifen
,	$,	,
woher	PWAV	woher
er	PPER.3.Nom.Sg.Masc	er
sie	PPER.3.Acc.Sg.Fem	sie
erhalten	VVPP.Psp	erhalten
hatte	VAFIN.3.Sg.Past.Ind	haben
,	$,	,
denn	KON	denn
es	PPER.3.Nom.Sg.Neut	es
war	VAFIN.3.Sg.Past.Ind	sein
ganz	ADV	ganz
trockenes	ADJA.Pos.Nom.Sg.Neut	trockene
Wetter	NN.Nom.Sg.Neut	Wetter
.	$.	.

