Fix	ADJD.Pos	fix
und	KON	und
Fertig	ADJD.Pos	fertig
war	VAFIN.3.Sg.Past.Ind	sein
lange	ADJA.Pos.Nom.Sg.Fem	lang
Zeit	NN.Nom.Sg.Fem	Zeit
Soldat	NN.Nom.Sg.Masc	Soldat
gewesen	VAPP.Psp	sein
,	$,	,
weil	KOUS	weil
aber	ADV	aber
der	ART.Nom.Sg.Masc	der
Krieg	NN.Nom.Sg.Masc	Krieg
ein	ART.Acc.Sg.Neut	ein
Ende	NN.Acc.Sg.Neut	Ende
hatte	VAFIN.3.Sg.Past.Ind	haben
und	KON	und
nichts	PIS.*.*.Neut	nichts
mehr	ADV	mehr
zu	PTKA	zu
thun	VVINF.Inf	thun
war	VAFIN.3.Sg.Past.Ind	sein
,	$,	,
als	KOKOM	als
einen	PIS.Acc.Sg.Masc	einer
und	KON	und
alle	PIAT.Acc.Pl.Masc	aller
Tage	NN.Acc.Pl.Masc	Tag
dasselbe	PDS.Nom.Sg.Neut	derselbe
,	$,	,
nahm	VVFIN.3.Sg.Past.Ind	nehmen
er	PPER.3.Nom.Sg.Masc	er
seinen	PPOSAT.Acc.Sg.Masc	sein
Abschied	NN.Acc.Sg.Masc	Abschied
und	KON	und
wollte	VMFIN.3.Sg.Past.Ind	wollen
Lakai	NE.Acc.Sg.*	Lakai
bei	APPR	bei
einem	ART.Dat.Sg.Masc	ein
großen	ADJA.Pos.Dat.Sg.Masc	groß
Herrn	NN.Dat.Sg.Masc	Herr
werden	VAINF.Inf	werden
.	$.	.

