Das	ART.Nom.Sg.Neut	der
größte	ADJA.Sup.Nom.Sg.Neut	groß
grüne	ADJA.Pos.Nom.Sg.Neut	grün
Blatt	NN.Nom.Sg.Neut	Blatt
hier	ADV	hier
zu	APPR	zu
Lande	NN.Dat.Sg.Neut	Land
ist	VAFIN.3.Sg.Pres.Ind	sein
sicherlich	ADV	sicherlich
das	ART.Nom.Sg.Neut	der
Klettenblatt	NN.Nom.Sg.Neut	Klettenblatt
;	$.	;
hält	VVFIN.3.Sg.Pres.Ind	halten
man	PIS.Nom.Sg.*	man
es	PPER.3.Acc.Sg.Neut	es
vor	APPR	vor
seinen	PPOSAT.Acc.Sg.Masc	sein
kleinen	ADJA.Pos.Acc.Sg.Masc	klein
Leib	NN.Acc.Sg.Masc	Leib
,	$,	,
so	ADV	so
ist	VAFIN.3.Sg.Pres.Ind	sein
es	PPER.3.Nom.Sg.Neut	es
gerade	ADV	gerade
wie	KOKOM	wie
eine	ART.Nom.Sg.Fem	ein
ganze	ADJA.Pos.Nom.Sg.Fem	ganz
Schürze	NN.Nom.Sg.Fem	Schürze
,	$,	,
und	KON	und
legt	VVFIN.3.Sg.Pres.Ind	legen
man	PIS.Nom.Sg.*	man
es	PPER.3.Acc.Sg.Neut	es
auf	APPR	auf
seinen	PPOSAT.Acc.Sg.Masc	sein
Kopf	NN.Acc.Sg.Masc	Kopf
,	$,	,
dann	ADV	dann
ist	VAFIN.3.Sg.Pres.Ind	sein
es	PPER.3.Nom.Sg.Neut	es
im	APPRART.Dat.Sg.Neut	in
Regenwetter	NN.Dat.Sg.Neut	Regenwetter
fast	ADV	fast
ebenso	ADV	ebenso
gut	ADJD.Pos	gut
wie	KOKOM	wie
ein	ART.Nom.Sg.Masc	ein
Regenschirm	NN.Nom.Sg.Masc	Regenschirm
,	$,	,
denn	KON	denn
es	PPER.3.Nom.Sg.Neut	es
ist	VAFIN.3.Sg.Pres.Ind	sein
ungeheuer	ADJD.Pos	ungeheuer
groß	ADJD.Pos	groß
.	$.	.

