Ein	ART.Nom.Sg.Masc	ein
König	NN.Nom.Sg.Masc	König
hatte	VAFIN.3.Sg.Past.Ind	haben
eine	ART.Acc.Sg.Fem	ein
Tochter	NN.Acc.Sg.Fem	Tochter
,	$,	,
die	PRELS.Nom.Sg.Fem	der
war	VAFIN.3.Sg.Past.Ind	sein
wunderschön	ADJD.Pos	wunderschön
,	$,	,
aber	KON	aber
so	ADV	so
stolz	ADJD.Pos	stolz
und	KON	und
übermüthig	ADJD.Pos	übermüthig
,	$,	,
daß	KOUS	daß
sie	PPER.3.Nom.Sg.Fem	sie
aus	APPR	aus
Eigensinn	NN.Dat.Sg.Masc	Eigensinn
einen	ART.Acc.Sg.Masc	ein
Freier	NN.Acc.Sg.Masc	Freier
nach	APPR	nach
dem	ART.Dat.Sg.Masc	der
andern	ADJA.Pos.Dat.Sg.Masc	anderer
abwies	VVFIN.3.Sg.Past.Ind	abweisen
und	KON	und
Spott	NN.Dat.Sg.Masc	Spott
mit	APPR	mit
ihnen	PPER.3.Dat.Pl.*	ihnen
trieb	VVFIN.3.Sg.Past.Ind	treiben
.	$.	.

