Vor	APPR	vor
vielen	PIAT.Dat.Pl.Neut	vieler
Jahren	NN.Dat.Pl.Neut	Jahr
lebte	VVFIN.3.Sg.Past.Ind	leben
ein	ART.Nom.Sg.Masc	ein
Kaiser	NN.Nom.Sg.Masc	Kaiser
,	$,	,
der	PRELS.Nom.Sg.Masc	der
so	ADV	so
ungeheuer	ADJD.Pos	ungeheuer
viel	ADV	viel
auf	APPR	auf
neue	ADJA.Pos.Acc.Pl.Neut	neu
Kleider	NN.Acc.Pl.Neut	Kleid
hielt	VVFIN.3.Sg.Past.Ind	halten
,	$,	,
daß	KOUS	daß
er	PPER.3.Nom.Sg.Masc	er
all	PIAT.*.*.*	all
'	$(	'
sein	PPOSAT.Acc.Sg.Neut	sein
Geld	NN.Acc.Sg.Neut	Geld
dafür	PROAV	dafür
ausgab	VVFIN.3.Sg.Past.Ind	ausgeben
,	$,	,
um	KOUI	um
recht	ADJD.Pos	recht
geputzt	VVPP.Psp	putzen
zu	PTKZU	zu
sein	VAINF.Inf	sein
.	$.	.

