Es	PPER.3.Nom.Sg.Neut	es
war	VAFIN.3.Sg.Past.Ind	sein
ein	ART.Nom.Sg.Masc	ein
reicher	ADJA.Pos.Nom.Sg.Masc	reicher
Bauer	NN.Nom.Sg.Masc	Bauer
,	$,	,
der	PRELS.Nom.Sg.Masc	der
hatte	VAFIN.3.Sg.Past.Ind	haben
mit	APPR	mit
seiner	PPOSAT.Dat.Sg.Fem	sein
Frau	NN.Dat.Sg.Fem	Frau
keine	PIAT.Acc.Pl.Neut	kein
Kinder	NN.Acc.Pl.Neut	Kind
;	$.	;
öfters	ADV	öfters
,	$,	,
wenn	KOUS	wenn
er	PPER.3.Nom.Sg.Masc	er
mit	APPR	mit
den	ART.Dat.Pl.Masc	der
andern	ADJA.Pos.Dat.Pl.Masc	anderer
Bauern	NN.Dat.Pl.Masc	Bauer
in	APPR	in
die	ART.Acc.Sg.Fem	der
Stadt	NN.Acc.Sg.Fem	Stadt
ging	VVFIN.3.Sg.Past.Ind	gehen
,	$,	,
spotteten	VVFIN.3.Pl.Past.Ind	spotten
sie	PPER.3.Nom.Pl.Masc	sie
ihn	PPER.3.Acc.Sg.Masc	ihn
und	KON	und
fragten	VVFIN.3.Pl.Past.Ind	fragen
,	$,	,
warum	PWAV	warum
er	PPER.3.Nom.Sg.Masc	er
keine	PIAT.Acc.Pl.Neut	kein
Kinder	NN.Acc.Pl.Neut	Kind
hätte	VAFIN.3.Sg.Past.Subj	haben
.	$.	.

