Es	PPER.3.Acc.Sg.Neut	es
saß	VVFIN.3.Sg.Past.Ind	sitzen
einmal	ADV	einmal
ein	ART.Nom.Sg.Masc	ein
Mann	NN.Nom.Sg.Masc	Mann
mit	APPR	mit
seiner	PPOSAT.Dat.Sg.Fem	sein
Frau	NN.Dat.Sg.Fem	Frau
vor	APPR	vor
der	ART.Dat.Sg.Fem	der
Hausthür	NN.Dat.Sg.Fem	Hausthür
,	$,	,
und	KON	und
hatten	VAFIN.3.Pl.Past.Ind	haben
ein	ART.Acc.Sg.Neut	ein
gebraten	ADJA.Pos.Acc.Sg.Masc	gebrat
Huhn	NN.Acc.Sg.Masc	Huhn
vor	APPR	vor
sich	PRF.3.Dat.Pl	sich
stehen	VVINF.Inf	stehen
,	$,	,
und	KON	und
wollten	VMFIN.3.Pl.Past.Ind	wollen
das	PDS.Acc.Sg.Neut	der
zusammen	ADV	zusammen
verzehren	VVINF.Inf	verzehren
,	$,	,
da	ADV	da
sah	VVFIN.3.Sg.Past.Ind	sehen
der	ART.Nom.Sg.Masc	der
Mann	NN.Nom.Sg.Masc	Mann
,	$,	,
wie	PWAV	wie
sein	PPOSAT.Nom.Sg.Masc	sein
alter	ADJA.Pos.Nom.Sg.Masc	alter
Vater	NN.Nom.Sg.Masc	Vater
daher	PROAV	daher
kam	VVFIN.3.Sg.Past.Ind	kommen
,	$,	,
geschwind	ADJD.Pos	geschwind
nahm	VVFIN.3.Sg.Past.Ind	nehmen
er	PPER.3.Nom.Sg.Masc	er
das	ART.Acc.Sg.Neut	der
Huhn	NN.Acc.Sg.Neut	Huhn
und	KON	und
versteckte	VVFIN.3.Sg.Past.Ind	verstecken
es	PPER.3.Acc.Sg.Neut	es
,	$,	,
weil	KOUS	weil
er	PPER.3.Nom.Sg.Masc	er
ihm	PPER.3.Dat.Sg.Neut	ihm
nichts	PIS.*.*.Neut	nichts
davon	PROAV	davon
gönnte	VVFIN.3.Sg.Past.Ind	gönnen
.	$.	.

