Der	ART.Nom.Sg.Masc	der
Floh	NN.Nom.Sg.Masc	Floh
,	$,	,
der	ART.Nom.Sg.Masc	der
Grashüpfer	NN.Nom.Sg.Masc	Grashüpfer
und	KON	und
der	ART.Nom.Sg.Masc	der
Springbock	NN.Nom.Sg.Masc	Springbock
wollten	VMFIN.3.Pl.Past.Ind	wollen
einmal	ADV	einmal
sehen	VVINF.Inf	sehen
,	$,	,
wer	PWS.Nom.Sg.Masc	wer
von	APPR	von
ihnen	PPER.3.Dat.Pl.*	ihnen
am	PTKA	am
höchsten	ADJD.Sup	hoch
springen	VVINF.Inf	springen
könne	VMFIN.3.Sg.Pres.Subj	können
und	KON	und
da	ADV	da
luden	VVFIN.3.Pl.Pres.Ind	luden
sie	PPER.3.Nom.Pl.*	sie
jeden	PIS.Acc.Sg.Masc	jeder
ein	PTKVZ	ein
,	$,	,
der	PRELS.Nom.Sg.Masc	der
kommen	VVINF.Inf	kommen
wollte	VMFIN.3.Sg.Past.Ind	wollen
,	$,	,
die	ART.Acc.Sg.Fem	der
Pracht	NN.Acc.Sg.Fem	Pracht
mit	ADV	mit
anzusehen	VVIZU.Infzu	ansehen
,	$,	,
und	KON	und
es	PPER.3.Nom.Sg.Neut	es
waren	VAFIN.3.Pl.Past.Ind	sein
drei	CARD	drei
tüchtige	ADJA.Pos.Nom.Pl.Masc	tüchtig
Springer	NN.Nom.Pl.Masc	Springer
,	$,	,
die	PRELS.Nom.Pl.Masc	der
sich	PRF.3.Acc.Pl	sich
im	APPRART.Dat.Sg.Neut	in
Zimmer	NN.Dat.Sg.Neut	Zimmer
versammelten	VVFIN.3.Pl.Past.Ind	versammeln
.	$.	.

