In	APPR	in
den	ART.Dat.Pl.Fem	der
alten	ADJA.Pos.Dat.Pl.Fem	alt
Zeiten	NN.Dat.Pl.Fem	Zeit
,	$,	,
wo	PWAV	wo
das	ART.Nom.Sg.Neut	der
Wünschen	NN.Nom.Sg.Neut	Wünschen
noch	ADV	noch
geholfen	VVPP.Psp	helfen
hat	VAFIN.3.Sg.Pres.Ind	haben
,	$,	,
lebte	VVFIN.3.Sg.Past.Ind	leben
ein	ART.Nom.Sg.Masc	ein
König	NN.Nom.Sg.Masc	König
,	$,	,
dessen	PRELAT.Gen.Sg.Masc	der
Töchter	NN.Nom.Pl.Fem	Tochter
waren	VAFIN.3.Pl.Past.Ind	sein
alle	PIS.Nom.Pl.*	alle
schön	ADJD.Pos	schön
,	$,	,
aber	KON	aber
die	ART.Nom.Sg.Fem	der
jüngste	ADJA.Sup.Nom.Sg.Fem	jung
war	VAFIN.3.Sg.Past.Ind	sein
so	ADV	so
schön	ADJD.Pos	schön
,	$,	,
daß	KOUS	daß
die	ART.Nom.Sg.Fem	der
Sonne	NN.Nom.Sg.Fem	Sonne
selber	ADV	selber
,	$,	,
die	PRELS.Nom.Sg.Fem	der
doch	ADV	doch
so	ADV	so
vieles	PIS.Acc.Sg.Neut	viele
gesehen	VVPP.Psp	sehen
hat	VAFIN.3.Sg.Pres.Ind	haben
,	$,	,
sich	PRF.3.Acc.Sg	sich
verwunderte	VVFIN.3.Sg.Past.Ind	verwundern
,	$,	,
sooft	ADV	sooft
sie	PPER.3.Nom.Sg.Fem	sie
ihr	PPER.3.Dat.Sg.Fem	ihr
ins	APPRART.Acc.Sg.Neut	in
Gesicht	NN.Acc.Sg.Neut	Gesicht
schien	VVFIN.3.Sg.Past.Ind	scheinen
.	$.	.

