Hans	NE.Nom.Sg.Masc	Hans
hatte	VAFIN.3.Sg.Past.Ind	haben
sieben	CARD	sieben
Jahre	NN.Acc.Pl.Neut	Jahr
bei	APPR	bei
seinem	PPOSAT.Dat.Sg.Masc	sein
Herrn	NN.Dat.Sg.Masc	Herr
gedient	VVPP.Psp	dienen
,	$,	,
da	ADV	da
sprach	VVFIN.3.Sg.Past.Ind	sprechen
er	PPER.3.Nom.Sg.Masc	er
zu	APPR	zu
ihm	PPER.3.Dat.Sg.Masc	ihm
»	XY	»
Herr	NN.Nom.Sg.Masc	Herr
,	$,	,
meine	PPOSAT.Nom.Sg.Fem	mein
Zeit	NN.Nom.Sg.Fem	Zeit
ist	VAFIN.3.Sg.Pres.Ind	sein
herum	PTKVZ	herum
,	$,	,
nun	ADV	nun
wollte	VMFIN.1.Sg.Past.Ind	wollen
ich	PPER.1.Nom.Sg.*	ich
gerne	ADV	gerne
wieder	ADV	wieder
heim	ADV	heim
zu	APPR	zu
meiner	PPOSAT.Dat.Sg.Fem	mein
Mutter	NN.Dat.Sg.Fem	Mutter
,	$,	,
gebt	VVFIN.3.Sg.Pres.Ind	geben
mir	PPER.1.Dat.Sg.*	mir
meinen	PPOSAT.Acc.Sg.Masc	mein
Lohn	NN.Acc.Sg.Masc	Lohn
.	$.	.
«	XY	«

