Es	PPER.3.Nom.Sg.Neut	es
war	VAFIN.3.Sg.Past.Ind	sein
ein	ART.Nom.Sg.Masc	ein
armer	ADJA.Pos.Nom.Sg.Masc	armer
Mann	NN.Nom.Sg.Masc	Mann
und	KON	und
eine	ART.Nom.Sg.Fem	ein
arme	ADJA.Pos.Nom.Sg.Fem	arm
Frau	NN.Nom.Sg.Fem	Frau
,	$,	,
die	PDS.Nom.Pl.*	der
hatten	VAFIN.3.Pl.Past.Ind	haben
nichts	PIS.*.*.Neut	nichts
als	KOKOM	als
eine	ART.Acc.Sg.Fem	ein
kleine	ADJA.Pos.Acc.Sg.Fem	kleine
H체tte	NN.Acc.Sg.Fem	H체tte
und	KON	und
n채hrten	VVFIN.3.Pl.Past.Ind	n채hren
sich	PRF.3.Acc.Pl	sich
vom	APPRART.Dat.Sg.Masc	von
Fischfang	NN.Dat.Sg.Masc	Fischfang
,	$,	,
und	KON	und
es	PPER.3.Nom.Sg.Neut	es
ging	VVFIN.3.Sg.Past.Ind	gehen
bei	APPR	bei
ihnen	PPER.3.Dat.Pl.*	ihnen
von	APPR	von
Hand	NN.Dat.Sg.Fem	Hand
zu	APPR	zu
Mund	NN.Dat.Sg.Masc	Mund
.	$.	.

