Ein	ART.Nom.Sg.Masc	ein
Bauersmann	NN.Nom.Sg.Masc	Bauersmann
hatte	VAFIN.3.Sg.Past.Ind	haben
einen	ART.Acc.Sg.Masc	ein
Sohn	NN.Acc.Sg.Masc	Sohn
,	$,	,
der	PRELS.Nom.Sg.Masc	der
war	VAFIN.3.Sg.Past.Ind	sein
so	ADV	so
groß	ADJD.Pos	groß
wie	KOKOM	wie
ein	ART.Nom.Sg.Neut	ein
Daumen	NN.Nom.Sg.Neut	Daumen
und	KON	und
ward	VVFIN.3.Sg.Past.Ind	werden
gar	ADV	gar
nicht	PTKNEG	nicht
größer	ADJD.Comp	groß
und	KON	und
wuchs	VVFIN.3.Sg.Past.Ind	wachsen
in	APPR	in
etlichen	ADJA.Pos.Dat.Pl.Neut	etlich
Jahren	NN.Dat.Pl.Neut	Jahr
nicht	PTKNEG	nicht
ein	ART.Nom.Sg.Masc	ein
Haarbreit	NN.Acc.Sg.Neut	Haarbreit
.	$.	.

