Wie	PWAV	wie
glücklich	ADJD.Pos	glücklich
ist	VAFIN.3.Sg.Pres.Ind	sein
der	ART.Nom.Sg.Masc	der
Herr	NN.Nom.Sg.Masc	Herr
,	$,	,
und	KON	und
wie	KOKOM	wie
wohl	ADV	wohl
steht	VVFIN.3.Sg.Pres.Ind	stehen
es	PPER.3.Nom.Sg.Neut	es
mit	APPR	mit
seinem	PPOSAT.Dat.Sg.Neut	sein
Hause	NN.Dat.Sg.Neut	Haus
,	$,	,
wenn	KOUS	wenn
er	PPER.3.Nom.Sg.Masc	er
einen	ART.Acc.Sg.Masc	ein
klugen	ADJA.Pos.Acc.Sg.Masc	klug
Knecht	NN.Acc.Sg.Masc	Knecht
hat	VAFIN.3.Sg.Pres.Ind	haben
,	$,	,
der	PRELS.Nom.Sg.Masc	der
auf	APPR	auf
seine	PPOSAT.Acc.Pl.Neut	sein
Worte	NN.Acc.Pl.Neut	Wort
zwar	ADV	zwar
hört	VVFIN.3.Sg.Pres.Ind	hören
,	$,	,
aber	KON	aber
nicht	PTKNEG	nicht
danach	PROAV	danach
tut	VVFIN.3.Sg.Pres.Ind	tun
und	KON	und
lieber	ADV	lieber
seiner	PPOSAT.Dat.Sg.Fem	sein
eigenen	ADJA.Pos.Dat.Sg.Fem	eigen
Weisheit	NN.Dat.Sg.Fem	Weisheit
folgt	VVFIN.3.Sg.Pres.Ind	folgen
.	$.	.

