Das	PDS.Nom.Sg.Neut	der
war	VAFIN.3.Sg.Past.Ind	sein
einmal	ADV	einmal
eines	ART.Gen.Sg.Masc	ein
Winters	NN.Gen.Sg.Masc	Winter
,	$,	,
da	KOUS	da
wars	VAFIN.3.Sg.Past.Ind	sein
sehr	ADV	sehr
kalt	ADJD.Pos	kalt
und	KON	und
gab	VVFIN.3.Sg.Past.Ind	geben
wenig	PIS.*.*.*	wenig
zu	PTKZU	zu
fressen	VVINF.Inf	fressen
,	$,	,
da	ADV	da
ging	VVFIN.3.Sg.Past.Ind	gehen
der	ART.Nom.Sg.Masc	der
Fuchs	NN.Nom.Sg.Masc	Fuchs
im	APPRART.Dat.Sg.Masc	in
Wald	NN.Dat.Sg.Masc	Wald
umher	PTKVZ	umher
und	KON	und
sann	VVFIN.3.Sg.Past.Ind	sinnen
,	$,	,
wie	PWAV	wie
er	PPER.3.Nom.Sg.Masc	er
sich	PRF.3.Dat.Sg	sich
Nahrung	NN.Acc.Sg.Fem	Nahrung
verschaffte	VVFIN.3.Sg.Past.Ind	verschaffen
.	$.	.

