Thomas	NE.Nom.Sg.Masc	Thomas
,	$,	,
der	ART.Nom.Sg.Masc	der
älteste	ADJA.Sup.Nom.Sg.Masc	alt
Sohn	NN.Nom.Sg.Masc	Sohn
eines	ART.Gen.Sg.Masc	ein
wohlhabenden	ADJA.Pos.Gen.Sg.Masc	wohlhabend
Pächters	NN.Gen.Sg.Masc	Pächter
,	$,	,
streifte	VVFIN.3.Sg.Past.Ind	streifen
an	APPR	an
einem	ART.Dat.Sg.Masc	ein
Sonntage	NN.Dat.Sg.Masc	Sonntag
zur	APPRART.Dat.Sg.Fem	zu
Herbstzeit	NN.Dat.Sg.Fem	Herbstzeit
durch	APPR	durch
die	ART.Acc.Pl.Neut	der
Felder	NN.Acc.Pl.Neut	Feld
,	$,	,
und	KON	und
ging	VVFIN.3.Sg.Past.Ind	gehen
eben	ADV	eben
an	APPR	an
der	ART.Dat.Sg.Fem	der
Sonnenseite	NN.Dat.Sg.Fem	Sonnenseite
einer	ART.Gen.Sg.Fem	ein
Hecke	NN.Gen.Sg.Fem	Hecke
daher	PROAV	daher
,	$,	,
als	KOUS	als
er	PPER.3.Nom.Sg.Masc	er
plötzlich	ADJD.Pos	plötzlich
ein	ART.Acc.Sg.Neut	ein
klapperndes	ADJA.Pos.Acc.Sg.Neut	klapperndes
Geräusch	NN.Acc.Sg.Neut	Geräusch
nicht	PTKNEG	nicht
weit	ADJD.Pos	weit
von	APPR	von
sich	PRF.3.Dat.Sg	sich
in	APPR	in
der	ART.Dat.Sg.Fem	der
Hecke	NN.Dat.Sg.Fem	Hecke
hörte	VVFIN.3.Sg.Past.Ind	hören
.	$.	.

