Es	PPER.3.Nom.Sg.Neut	es
war	VAFIN.3.Sg.Past.Ind	sein
einmal	ADV	einmal
ein	ART.Nom.Sg.Masc	ein
armer	ADJA.Pos.Nom.Sg.Masc	armer
Mann	NN.Nom.Sg.Masc	Mann
,	$,	,
der	PRELS.Nom.Sg.Masc	der
hatte	VAFIN.3.Sg.Past.Ind	haben
einen	ART.Acc.Sg.Masc	ein
großen	ADJA.Pos.Acc.Sg.Masc	groß
Höcker	NN.Acc.Sg.Masc	Höcker
auf	APPR	auf
dem	ART.Dat.Sg.Masc	der
Rücken	NN.Dat.Sg.Masc	Rücken
,	$,	,
und	KON	und
es	PPER.3.Nom.Sg.Neut	es
sah	VVFIN.3.Sg.Past.Ind	sehen
gerade	ADV	gerade
aus	PTKVZ	aus
,	$,	,
als	KOKOM	als
wäre	VAFIN.3.Sg.Past.Subj	sein
sein	PPOSAT.Nom.Sg.Masc	sein
Leib	NN.Nom.Sg.Masc	Leib
heraufgeschoben	VVPP.Psp	heraufschieben
,	$,	,
und	KON	und
auf	APPR	auf
seine	PPOSAT.Acc.Pl.Fem	sein
Schultern	NN.Acc.Pl.Fem	Schulter
gelegt	VVPP.Psp	legen
worden	VAPP.Psp	werden
.	$.	.

