Vor	APPR	vor
Zeiten	NN.Dat.Pl.Fem	Zeit
war	VAFIN.3.Sg.Past.Ind	sein
einmal	ADV	einmal
ein	ART.Nom.Sg.Masc	ein
armer	ADJA.Pos.Nom.Sg.Masc	armer
Holzhacker	NE.Nom.Sg.Masc	Holzhacker
und	KON	und
seine	PPOSAT.Nom.Sg.Fem	sein
Frau	NN.Nom.Sg.Fem	Frau
,	$,	,
die	PRELS.Acc.Sg.Fem	der
hatten	VAFIN.3.Pl.Past.Ind	haben
sieben	CARD	sieben
scharmante	ADJA.Pos.Acc.Pl.Neut	scharmant
Kinder	NN.Acc.Pl.Neut	Kind
,	$,	,
lauter	PIAT.*.*.*	lauter
Jungen	NN.Acc.Pl.Masc	Junge
,	$,	,
von	APPR	von
welchen	PWAT.Dat.Pl.Fem	welcher
der	ART.Nom.Sg.Masc	der
jüngste	ADJA.Sup.Nom.Sg.Masc	jung
sieben	CARD	sieben
Jahre	NN.Acc.Pl.Neut	Jahr
alt	ADJD.Pos	alt
seyn	VVINF.Inf	seyn
mochte	VVFIN.3.Sg.Past.Ind	mögen
.	$.	.

