Martin	NE.Nom.Sg.*	Martin
und	KON	und
Ilse	NE.Nom.Sg.*	Ilse
waren	VAFIN.3.Pl.Past.Ind	sein
Bruder	NN.Nom.Sg.Masc	Bruder
und	KON	und
Schwester	NN.Nom.Sg.Fem	Schwester
,	$,	,
und	KON	und
waren	VAFIN.3.Pl.Past.Ind	sein
recht	ADJD.Pos	recht
sehr	ADV	sehr
arme	ADJA.Pos.Nom.Pl.Neut	arm
Kinder	NN.Nom.Pl.Neut	Kind
,	$,	,
denn	KON	denn
die	ART.Nom.Pl.*	der
Aeltern	NN.Nom.Pl.*	Aeltern
hatten	VAFIN.3.Pl.Past.Ind	haben
noch	ADV	noch
viel	PIAT.*.*.*	viel
Kinder	NN.Acc.Pl.Neut	Kind
mehr	PIS.*.*.*	mehr
und	KON	und
konnten	VMFIN.3.Pl.Past.Ind	können
ihnen	PPER.3.Dat.Pl.*	ihnen
nicht	PTKNEG	nicht
satt	ADJD.Pos	satt
zu	PTKZU	zu
eßen	VVINF.Inf	essen
geben	VVINF.Inf	geben
.	$.	.

