Rübezahl	NE.Nom.Sg.Masc	Rübezahl
hatte	VAFIN.3.Sg.Past.Ind	haben
schon	ADV	schon
Jahrtausende	NN.Acc.Pl.Neut	Jahrtausend
zuvor	ADV	zuvor
,	$,	,
ehe	KOUS	ehe
noch	ADV	noch
Menschen	NN.Nom.Pl.Masc	Mensch
daselbst	ADV	daselbst
wohnten	VVFIN.3.Pl.Past.Ind	wohnen
,	$,	,
im	APPRART.Dat.Sg.Neut	in
Riesengebirge	NN.Dat.Sg.Neut	Riesengebirge
gehaust	VVPP.Psp	hausen
,	$,	,
denn	KON	denn
er	PPER.3.Nom.Sg.Masc	er
war	VAFIN.3.Sg.Past.Ind	sein
der	ART.Nom.Sg.Masc	der
Geist	NN.Nom.Sg.Masc	Geist
des	ART.Gen.Sg.Neut	der
Gebirges	NN.Gen.Sg.Neut	Gebirge
,	$,	,
der	PRELS.Nom.Sg.Masc	der
in	APPR	in
den	ART.Dat.Pl.Fem	der
innersten	ADJA.Sup.Dat.Pl.Fem	innerer
Tiefen	NN.Dat.Pl.Fem	Tiefe
und	KON	und
Schluchten	NN.Dat.Pl.Fem	Schlucht
deßelben	VVFIN.3.Pl.Pres.Ind	deßelben
eigentlich	ADV	eigentlich
sein	PPOSAT.Acc.Sg.Neut	sein
Wesen	NN.Acc.Sg.Neut	Wesen
treiben	VVINF.Inf	treiben
und	KON	und
über	APPR	über
die	ART.Acc.Sg.Fem	der
Berggeister	ADJA.Pos.*.*.*	Berggeister
Aussicht	NN.Acc.Sg.Fem	Aussicht
führen	VVINF.Inf	führen
mußte	VMFIN.3.Sg.Past.Ind	müssen
,	$,	,
welche	PWAT.Nom.Pl.Neut	welcher
Gold	NN.Acc.Sg.Neut	Gold
und	KON	und
Silber	NN.Acc.Sg.Neut	Silber
und	KON	und
anderes	ADJA.Pos.Acc.Sg.Neut	anderer
Metall	NN.Acc.Sg.Neut	Metall
,	$,	,
oder	KON	oder
böse	ADJA.Pos.Acc.Pl.Neut	böse
Gifte	NN.Acc.Pl.Neut	Gift
und	KON	und
Wetter	NN.Acc.Sg.Neut	Wetter
zu	PTKZU	zu
bereiten	VVINF.Inf	bereiten
hatten	VAFIN.3.Pl.Past.Ind	haben
.	$.	.

