Vor	APPR	vor
einem	ART.Dat.Sg.Neut	ein
Wirtshaus	NN.Dat.Sg.Neut	Wirtshaus
im	APPRART.Dat.Sg.Masc	in
Walde	NN.Dat.Sg.Masc	Wald
hielt	VVFIN.3.Sg.Past.Ind	halten
ein	ART.Nom.Sg.Masc	ein
junger	ADJA.Pos.Nom.Sg.Masc	junger
stattlicher	ADJA.Pos.Nom.Sg.Masc	stattlicher
Reitersmann	NN.Nom.Sg.Masc	Reitersmann
,	$,	,
da	ADV	da
trat	VVFIN.3.Sg.Past.Ind	treten
eine	ART.Nom.Sg.Fem	ein
feine	ADJA.Pos.Nom.Sg.Fem	fein
Maid	NN.Nom.Sg.Fem	Maid
aus	APPR	aus
der	ART.Dat.Sg.Fem	der
Türe	NN.Dat.Sg.Fem	Türe
,	$,	,
grüßte	VVFIN.3.Sg.Past.Ind	grüßen
ihn	PPER.3.Acc.Sg.Masc	ihn
züchtig	ADJD.Pos	züchtig
,	$,	,
und	KON	und
fragte	VVFIN.3.Sg.Past.Ind	fragen
,	$,	,
was	PWS.Acc.Sg.Neut	was
er	PPER.3.Nom.Sg.Masc	er
begehre	VVFIN.3.Sg.Pres.Subj	begehren
.	$.	.

