Unfern	NN.Nom.Sg.Neut	Unfern
der	ART.Gen.Sg.Fem	der
Stadt	NN.Gen.Sg.Fem	Stadt
Zwickau	NE.Nom.Sg.Neut	Zwickau
,	$,	,
im	APPRART.Dat.Sg.Neut	in
Erzgebürge	NE.Dat.Sg.Neut	Erzgebürge
,	$,	,
liegt	VVFIN.3.Sg.Pres.Ind	liegen
das	ART.Nom.Sg.Neut	der
bekannte	ADJA.Pos.Nom.Sg.Neut	bekannt
Schwanenfeld	NN.Nom.Sg.Neut	Schwanenfeld
,	$,	,
welches	PRELS.Nom.Sg.Neut	welcher
den	ART.Acc.Sg.Masc	der
Namen	NN.Acc.Sg.Masc	Name
hat	VAFIN.3.Sg.Pres.Ind	haben
von	APPR	von
einem	ART.Dat.Sg.Masc	ein
Weiher	NN.Dat.Sg.Masc	Weiher
,	$,	,
der	PRELS.Nom.Sg.Masc	der
Schwanenteich	NN.Nom.Sg.Masc	Schwanenteich
genannt	VVPP.Psp	nennen
,	$,	,
der	PRELS.Nom.Sg.Masc	der
heutzutage	ADV	heutzutage
zwar	ADV	zwar
beinahe	ADV	beinahe
versiegt	VVFIN.3.Sg.Pres.Ind	versiegen
aber	ADV	aber
doch	ADV	doch
noch	ADV	noch
nicht	PTKNEG	nicht
ausgetrocknet	ADJD.Pos	ausgetrocknet
ist	VAFIN.3.Sg.Pres.Ind	sein
.	$.	.

