So	ADV	so
ist	VAFIN.3.Sg.Pres.Ind	sein
denn	ADV	denn
auch	ADV	auch
einmal	ADV	einmal
ein	ART.Nom.Sg.Masc	ein
Prinz	NN.Nom.Sg.Masc	Prinz
von	APPR	von
Engeland	NE.Dat.Sg.Neut	Engeland
gewesen	VAPP.Psp	sein
,	$,	,
das	PDS.Nom.Sg.Neut	der
war	VAFIN.3.Sg.Past.Ind	sein
der	ART.Nom.Sg.Masc	der
jüngste	ADJA.Sup.Nom.Sg.Masc	jung
von	APPR	von
vielen	PIAT.Dat.Pl.Masc	viele
Brüdern	NN.Dat.Pl.Masc	Bruder
,	$,	,
der	PDS.Nom.Sg.Masc	der
hielt	VVFIN.3.Sg.Past.Ind	halten
um	APPR	um
die	ART.Acc.Sg.Fem	der
Prinzessin	NN.Acc.Sg.Fem	Prinzessin
von	APPR	von
Portugal	NE.Dat.Sg.Neut	Portugal
an	PTKVZ	an
.	$.	.

