Es	PPER.3.Nom.Sg.Neut	es
war	VAFIN.3.Sg.Past.Ind	sein
einmal	ADV	einmal
ein	ART.Nom.Sg.Masc	ein
König	NN.Nom.Sg.Masc	König
,	$,	,
der	PRELS.Nom.Sg.Masc	der
erbaute	VVFIN.3.Sg.Past.Ind	erbauen
ein	ART.Acc.Sg.Neut	ein
prachtvolles	ADJA.Pos.Acc.Sg.Neut	prachtvolles
Münster	NN.Acc.Sg.Neut	Münster
zur	APPRART.Dat.Sg.Fem	zu
Ehre	NN.Dat.Sg.Fem	Ehre
und	KON	und
zum	APPRART.Dat.Sg.Neut	zu
Lobe	NN.Dat.Sg.Neut	Lob
Gottes	NN.Gen.Sg.Masc	Gott
und	KON	und
durfte	VMFIN.3.Sg.Past.Ind	dürfen
niemand	PIS.Nom.Sg.Masc	niemand
zu	APPR	zu
diesem	PDAT.Dat.Sg.Masc	dieser
Bau	NN.Dat.Sg.Masc	Bau
einen	ART.Acc.Sg.Masc	ein
Heller	NN.Acc.Sg.Masc	Heller
beisteuern	VVINF.Inf	beisteuern
,	$,	,
nach	APPR	nach
des	ART.Gen.Sg.Masc	der
Königs	NN.Gen.Sg.Masc	König
ausdrücklichem	ADJA.Pos.Dat.Sg.Neut	ausdrücklichem
Gebot	NN.Dat.Sg.Neut	Gebot
,	$,	,
sondern	KON	sondern
er	PPER.3.Nom.Sg.Masc	er
wollte	VMFIN.3.Sg.Past.Ind	wollen
es	PPER.3.Acc.Sg.Neut	es
ganz	ADV	ganz
aus	APPR	aus
dem	ART.Dat.Sg.Masc	der
eignen	ADJA.Pos.Dat.Sg.Masc	eignen
Schatz	NN.Dat.Sg.Masc	Schatz
erbauen	VVINF.Inf	erbauen
.	$.	.

