Die	ART.Acc.Sg.Fem	der
Nachtſtunde	NN.Acc.Sg.Fem	Nacht<unk>tunde
ſchlug	VVFIN.3.Sg.Past.Ind	chlagen
;	$.	;
ich	PPER.1.Nom.Sg.*	ich
huͤllte	VVFIN.1.Sg.Past.Ind	hu<unk>llen
mich	PRF.1.Acc.Sg	sich
in	APPR	in
meine	PPOSAT.Acc.Sg.Fem	mein
abenteuerliche	ADJA.Pos.Acc.Sg.Fem	abenteuerlich
Vermummung	NN.Acc.Sg.Fem	Vermummung
,	$,	,
nahm	VVFIN.3.Sg.Past.Ind	nehmen
die	ART.Acc.Sg.Fem	der
Pike	NN.Acc.Sg.Fem	Pike
und	KON	und
das	ART.Acc.Sg.Neut	der
Horn	NN.Acc.Sg.Neut	Horn
zur	APPRART.Dat.Sg.Fem	zu
Hand	NN.Dat.Sg.Fem	Hand
,	$,	,
ging	VVFIN.3.Sg.Past.Ind	gehen
in	APPR	in
die	ART.Acc.Sg.Fem	der
Finſterniß	NN.Acc.Sg.Fem	Fin<unk>terniß
hinaus	PTKVZ	hinaus
und	KON	und
rief	VVFIN.3.Sg.Past.Ind	rufen
die	ART.Acc.Sg.Fem	der
Stunde	NN.Acc.Sg.Fem	Stunde
ab	PTKVZ	ab
,	$,	,
nachdem	KOUS	nachdem
ich	PPER.1.Nom.Sg.*	ich
mich	PRF.1.Acc.Sg	sich
durch	APPR	durch
ein	ART.Acc.Sg.Neut	ein
Kreuz	NN.Acc.Sg.Neut	Kreuz
gegen	APPR	gegen
die	ART.Acc.Pl.Masc	der
boͤſen	ADJA.Pos.Acc.Pl.Masc	bo<unk><unk>
Geiſter	NN.Acc.Pl.Masc	Gei<unk>t
geſchuͤtzt	VVPP.Psp	<unk>
hatte	VAFIN.1.Sg.Past.Ind	haben
.	$.	.

