Der	ART.Nom.Sg.Masc	der
Paſtor	NN.Nom.Sg.Masc	Pa<unk>tor
Sebaldus	NE.Nom.Sg.Masc	Sebaldus
und	KON	und
die	ART.Nom.Sg.Fem	der
ſchoͤne	ADJA.Pos.Nom.Sg.Fem	<unk>
Wilhelmine	NN.Nom.Sg.Fem	Wilhelmine
,	$,	,
brachten	VVFIN.3.Pl.Past.Ind	bringen
die	ART.Nom.Pl.Masc	der
erſten	ADJA.Pos.Acc.Pl.Masc	er<unk>t
Monate	NN.Acc.Pl.Masc	Monat
nach	APPR	nach
ihrer	PPOSAT.Dat.Sg.Fem	ihr
Verheirathung	NN.Dat.Sg.Fem	Verheirathung
,	$,	,
welche	PWAT.Nom.Pl.Neut	welcher
ſonſt	ADV	<unk>
andern	ADJA.Pos.Dat.Pl.Neut	anderer
neuverehlichten	ADJA.Pos.Dat.Pl.Neut	neuverehlicht
Paaren	NN.Dat.Pl.Neut	Paar
die	ART.Acc.Sg.Fem	der
Zeit	NN.Acc.Sg.Fem	Zeit
einer	ART.Gen.Sg.Fem	ein
girrenden	ADJA.Pos.Gen.Sg.Fem	girrend
Zaͤrtlichkeit	NN.Gen.Sg.Fem	Za<unk>rtlichkeit
zu	PTKZU	zu
ſeyn	VVINF.Inf	pflichtbewußt
pflegen	VVFIN.3.Pl.Pres.Ind	pflegen
,	$,	,
vielmehr	ADV	vielmehr
in	APPR	in
einer	ART.Dat.Sg.Fem	ein
Art	NN.Dat.Sg.Fem	Art
von	APPR	von
Kaͤlte	NN.Dat.Sg.Fem	Ka<unk>lte
und	KON	und
Verlegenheit	NN.Dat.Sg.Fem	Verlegenheit
zu	PTKVZ	zu
.	$.	.

