In	APPR	in
eine	ART.Acc.Sg.Fem	ein
elende	ADJA.Pos.Acc.Sg.Fem	elend
Poſtchaiſe	NN.Acc.Sg.Fem	Po<unk>tchai<unk>e
gepackt	VVPP.Psp	packen
,	$,	,
die	PRELS.Acc.Sg.Fem	der
die	ART.Acc.Pl.Fem	der
Motten	NN.Acc.Pl.Fem	Motte
,	$,	,
wie	KOKOM	wie
die	ART.Nom.Pl.Fem	der
Ratten	NN.Nom.Pl.Fem	Ratte
Prospero's	NE.Gen.Sg.*	Prospero
Fahrzeug	NN.Nom.Sg.Neut	Fahrzeug
,	$,	,
aus	APPR	aus
Inſtinkt	NN.Dat.Sg.Masc	In<unk>tinkt
verlaſſen	VVPP.Psp	verla<unk>en
hatten	VAFIN.3.Pl.Past.Ind	haben
,	$,	,
hielt	VVFIN.1.Sg.Past.Ind	halten
ich	PPER.1.Nom.Sg.*	ich
endlich	ADV	endlich
,	$,	,
nach	APPR	nach
halsbrechender	ADJA.Pos.Dat.Sg.Fem	halsbrechender
Fahrt	NN.Dat.Sg.Fem	Fahrt
,	$,	,
halbgeraͤdert	VVPP.Psp	halbra<unk>dern
,	$,	,
vor	APPR	vor
dem	ART.Dat.Sg.Neut	der
Wirthshauſe	NN.Dat.Sg.Neut	Wirthshau<unk>
auf	APPR	auf
dem	ART.Dat.Sg.Masc	der
Markte	NN.Dat.Sg.Masc	Markt
in	APPR	in
G.	NN.Dat.Sg.Neut	G.

