Gebizo	NN.Nom.Sg.Neut	Gebizo
hatte	VAFIN.3.Sg.Past.Ind	haben
zu	APPR	zu
ſeinen	PPOSAT.Dat.Pl.Fem	<unk>
früheren	ADJA.Comp.Dat.Pl.Fem	früh
Beſitzungen	NN.Dat.Pl.Fem	Be<unk>itzung
noch	ADV	noch
ſo	ADV	<unk>
viele	PIAT.Acc.Pl.Fem	vieler
neue	ADJA.Pos.Acc.Pl.Fem	neu
erworben	VVPP.Psp	erwerben
,	$,	,
daß	KOUS	daß
Bertrade	NE.Nom.Sg.Masc	Bertrade
über	APPR	über
eine	ART.Acc.Sg.Fem	ein
bedeutende	ADJA.Pos.Acc.Sg.Fem	bedeutend
Grafſchaft	NN.Acc.Sg.Fem	Graf<unk>chaft
gebot	VVFIN.3.Sg.Past.Ind	gebieten
und	KON	und
ſowohl	ADV	<unk>
ihres	PPOSAT.Gen.Sg.Masc	ihr
Reichthums	NN.Gen.Sg.Masc	Reichthum
als	APPR	als
ihrer	PPOSAT.Dat.Sg.Fem	ihr
Schönheit	NN.Dat.Sg.Fem	Schönheit
wegen	APPO	wegen
im	APPRART.Dat.Sg.Neut	in
deutſchen	ADJA.Pos.Dat.Sg.Neut	deut<unk>ch
Reiche	NN.Dat.Sg.Neut	Reiche
berühmt	ADJD.Pos	berühmt
wurde	VAFIN.3.Sg.Past.Ind	werden
.	$.	.

